"filename", "language", "Java", "comment", "blank", "total"
"/home/brandonef/Documents/Spring 2024/CSC 1351/sbrand-BasicGraphics/src/oldFinalProject/Bomb.java", "Java", 37, 0, 11, 48
"/home/brandonef/Documents/Spring 2024/CSC 1351/sbrand-BasicGraphics/src/oldFinalProject/Bullet.java", "Java", 61, 9, 12, 82
"/home/brandonef/Documents/Spring 2024/CSC 1351/sbrand-BasicGraphics/src/oldFinalProject/Enemy.java", "Java", 78, 22, 14, 114
"/home/brandonef/Documents/Spring 2024/CSC 1351/sbrand-BasicGraphics/src/oldFinalProject/Life.java", "Java", 10, 0, 2, 12
"/home/brandonef/Documents/Spring 2024/CSC 1351/sbrand-BasicGraphics/src/oldFinalProject/PinwheelEnemy.java", "Java", 108, 15, 34, 157
"/home/brandonef/Documents/Spring 2024/CSC 1351/sbrand-BasicGraphics/src/oldFinalProject/RhombusEnemy.java", "Java", 74, 1, 17, 92
"/home/brandonef/Documents/Spring 2024/CSC 1351/sbrand-BasicGraphics/src/oldFinalProject/Shooter.java", "Java", 93, 5, 15, 113
"/home/brandonef/Documents/Spring 2024/CSC 1351/sbrand-BasicGraphics/src/oldFinalProject/Stars.java", "Java", 81, 22, 16, 119
"/home/brandonef/Documents/Spring 2024/CSC 1351/sbrand-BasicGraphics/src/oldFinalProject/WeaverEnemy.java", "Java", 96, 30, 34, 160
"/home/brandonef/Documents/Spring 2024/CSC 1351/sbrand-BasicGraphics/src/oldFinalProject/myGame.java", "Java", 501, 59, 48, 608
"Total", "-", 1139, 163, 203, 1505